11111111111111111111111111111
1P0C0C0C0C0C0C0C0C0C0C0C0C0C1
10111111111110111111111111111
10100C0C0C0C0C0C0C0C0C0C0C0C1
10100111110001111111111111111
1010010000000000E000000000001
10100111111111111111111100111
10100100100000000000000000001
10100000100000000000000000001
11111111111111111111111111111
