11111
1P001
10E01
1C001
11110
