11111
1P001
10001
1C001
11111
