11111
1P111
11111
1CE11
11111
