111111111111
1P1C00000001
101111111101
100000C00101
111111101101
1C000000E001
111111111111
