1111111111
1P0001C001
111100C001
1E00C1C001
1111111111
