1111111111111111
10C00110C0000C01
1P01C1000100E001
10010C0C00001001
1111111111111111