1111111111
10CC00C001
1C10000001
111P000001
100E0C0001
1000000001
1C00000001
1000011101
1C0001C101
1111010001
1C00011111
1000C00001
1111111111
