1111111
10C00C1
1P0E001
1111111