111111
1P00C1
100011
1C0E11
111111
